1111111111111111111111111111111111
1C00010C00C0000C0C000C00X000000001
10100101101000001010011111011111C1
1010010010111111101001000000000111
1P100C001C10C0000010010000000000E1
1111111111111111111111111111111111